Year,Debates,Ad Hominem,Appeal to Authority,Appeal to Emotion,False Cause,Slippery Slope,Slogans,Total
1960,4,10,24,95,12,12,1,154
1976,3,5,8,42,4,4,4,67
1980,2,5,12,77,2,3,5,104
1984,2,3,13,35,3,3,3,60
1988,1,4,19,31,2,3,4,63
1992,2,11,19,74,8,3,2,117
1996,2,10,24,93,6,2,10,145
2000,4,8,25,140,5,8,11,197
2004,4,32,38,135,13,10,4,232
2008,3,7,21,67,4,1,2,102
2012,1,0,2,16,1,1,2,22
2016,3,93,29,211,9,7,16,365
2020,3,62,17,147,0,4,2,232
Total,34,250,251,1163,69,61,66,1860
